;Level 12 - In the Mine

 ############
 #$   O  O  #
 ## #  #  # #
 #$ # O O h #
 #  # # # # #
 #$ h # #$#$#
 ## # # #####
 #$   #  @ x#
 ############
