;Level 8 - Traps and Treasure

 ########
 #      #
 # @    #########
 ###### #O $#   #
 #    # O   O   #
 # x  #$#$$O#$O$#
 ####O#######$###
 #   O $#$  #   #
 #O$O O #$  #   #
 #$O   O#   O   #
 #O O   #h##### #
 #$O OO    O O  #
 #O     #O  O   #
 ################
